___T__T___
__TT__TTTT
_X_______T
TTTT__T__T
_____P____
__X_______
__________
__________